"filename", "language", "C++", "Shell Script", "comment", "blank", "total"
"c:\Users\L1nSn0w\Desktop\CLibrary\DataStructure\Graph\source\AdjacencyMatrix.cpp", "C++", -321, 0, -65, -77, -463
"c:\Users\L1nSn0w\Desktop\CLibrary\DataStructure\Graph\source\AdjacencyTable.cpp", "C++", -282, 0, -43, -63, -388
"c:\Users\L1nSn0w\Desktop\CLibrary\DataStructure\Graph\source\Common.cpp", "C++", -206, 0, -47, -60, -313
"c:\Users\L1nSn0w\Desktop\CLibrary\DataStructure\Graph\source\CrossList.cpp", "C++", -311, 0, -39, -60, -410
"c:\Users\L1nSn0w\Desktop\CLibrary\DataStructure\Graph\source\EdgeList.cpp", "C++", -137, 0, -22, -29, -188
"c:\Users\L1nSn0w\Desktop\CLibrary\DataStructure\Graph\source\Exception.cpp", "C++", -17, 0, 0, -4, -21
"c:\Users\L1nSn0w\Desktop\CLibrary\DataStructure\Graph\source\Graph.cpp", "C++", -261, 0, -47, -82, -390
"c:\Users\L1nSn0w\Desktop\CLibrary\DataStructure\Graph\source\Graph.hpp", "C++", -176, 0, -22, -43, -241
"c:\Users\L1nSn0w\Desktop\CLibrary\DataStructure\Graph\source\Headers\AdjacencyMatrix.hpp", "C++", 343, 0, 79, 78, 500
"c:\Users\L1nSn0w\Desktop\CLibrary\DataStructure\Graph\source\Headers\AdjacencyTable.hpp", "C++", 381, 0, 70, 90, 541
"c:\Users\L1nSn0w\Desktop\CLibrary\DataStructure\Graph\source\Headers\Common.hpp", "C++", 219, 0, 50, 63, 332
"c:\Users\L1nSn0w\Desktop\CLibrary\DataStructure\Graph\source\Headers\CrossList.hpp", "C++", 464, 0, 97, 94, 655
"c:\Users\L1nSn0w\Desktop\CLibrary\DataStructure\Graph\source\Headers\Edge.h", "C++", 20, 0, 4, 4, 28
"c:\Users\L1nSn0w\Desktop\CLibrary\DataStructure\Graph\source\Headers\Graph.h", "C++", 157, 0, 44, 53, 254
"c:\Users\L1nSn0w\Desktop\CLibrary\DataStructure\Graph\source\Headers\Graph.hpp", "C++", 650, 0, 144, 195, 989
"c:\Users\L1nSn0w\Desktop\CLibrary\DataStructure\Graph\source\Headers\Iterator.h", "C++", 49, 0, 4, 13, 66
"c:\Users\L1nSn0w\Desktop\CLibrary\DataStructure\Graph\source\Headers\Iterator.hpp", "C++", 34, 0, 4, 9, 47
"c:\Users\L1nSn0w\Desktop\CLibrary\DataStructure\Graph\source\Headers\Vertex.h", "C++", 27, 0, 5, 8, 40
"c:\Users\L1nSn0w\Desktop\CLibrary\DataStructure\Graph\source\Headers\test.hpp", "C++", 256, 0, 22, 37, 315
"c:\Users\L1nSn0w\Desktop\CLibrary\DataStructure\Graph\source\Iterator.hpp", "C++", -33, 0, -3, -7, -43
"c:\Users\L1nSn0w\Desktop\CLibrary\DataStructure\Graph\source\Test.cpp", "C++", -168, 0, -30, -31, -229
"c:\Users\L1nSn0w\Desktop\CLibrary\DataStructure\Graph\source\build.sh", "Shell Script", 0, -3, 0, -4, -7
"c:\Users\L1nSn0w\Desktop\CLibrary\DataStructure\Graph\source\edge.hpp", "C++", -19, 0, -4, -5, -28
"c:\Users\L1nSn0w\Desktop\CLibrary\DataStructure\Graph\source\vertex.hpp", "C++", -17, 0, -4, -4, -25
"Total", "-", 652, -3, 197, 175, 1021