"filename", "language", "C++", "Shell Script", "comment", "blank", "total"
"c:\Users\L1nSn0w\Desktop\CLibrary\DataStructure\Graph\source\AdjacencyMatrix.cpp", "C++", 321, 0, 65, 77, 463
"c:\Users\L1nSn0w\Desktop\CLibrary\DataStructure\Graph\source\AdjacencyTable.cpp", "C++", 282, 0, 43, 63, 388
"c:\Users\L1nSn0w\Desktop\CLibrary\DataStructure\Graph\source\Common.cpp", "C++", 206, 0, 47, 60, 313
"c:\Users\L1nSn0w\Desktop\CLibrary\DataStructure\Graph\source\CrossList.cpp", "C++", 0, 0, 0, 1, 1
"c:\Users\L1nSn0w\Desktop\CLibrary\DataStructure\Graph\source\EdgeList.cpp", "C++", 137, 0, 22, 29, 188
"c:\Users\L1nSn0w\Desktop\CLibrary\DataStructure\Graph\source\Exception.cpp", "C++", 17, 0, 0, 4, 21
"c:\Users\L1nSn0w\Desktop\CLibrary\DataStructure\Graph\source\Graph.cpp", "C++", 380, 0, 69, 113, 562
"c:\Users\L1nSn0w\Desktop\CLibrary\DataStructure\Graph\source\Graph.hpp", "C++", 161, 0, 22, 44, 227
"c:\Users\L1nSn0w\Desktop\CLibrary\DataStructure\Graph\source\Iterator.hpp", "C++", 33, 0, 3, 7, 43
"c:\Users\L1nSn0w\Desktop\CLibrary\DataStructure\Graph\source\Test.cpp", "C++", 168, 0, 30, 31, 229
"c:\Users\L1nSn0w\Desktop\CLibrary\DataStructure\Graph\source\build.sh", "Shell Script", 0, 3, 0, 4, 7
"c:\Users\L1nSn0w\Desktop\CLibrary\DataStructure\Graph\source\edge.hpp", "C++", 19, 0, 4, 3, 26
"c:\Users\L1nSn0w\Desktop\CLibrary\DataStructure\Graph\source\vertex.hpp", "C++", 17, 0, 4, 4, 25
"Total", "-", 1741, 3, 309, 440, 2493