"filename", "language", "C++", "comment", "blank", "total"
"c:\Users\L1nSn0w\Desktop\CLibrary\DataStructure\Graph\source\Headers\AdjacencyMatrix.hpp", "C++", 343, 79, 78, 500
"c:\Users\L1nSn0w\Desktop\CLibrary\DataStructure\Graph\source\Headers\AdjacencyTable.hpp", "C++", 381, 70, 90, 541
"c:\Users\L1nSn0w\Desktop\CLibrary\DataStructure\Graph\source\Headers\Common.hpp", "C++", 219, 50, 63, 332
"c:\Users\L1nSn0w\Desktop\CLibrary\DataStructure\Graph\source\Headers\CrossList.hpp", "C++", 464, 97, 94, 655
"c:\Users\L1nSn0w\Desktop\CLibrary\DataStructure\Graph\source\Headers\Edge.h", "C++", 20, 4, 4, 28
"c:\Users\L1nSn0w\Desktop\CLibrary\DataStructure\Graph\source\Headers\Graph.h", "C++", 158, 44, 53, 255
"c:\Users\L1nSn0w\Desktop\CLibrary\DataStructure\Graph\source\Headers\Graph.hpp", "C++", 665, 145, 202, 1012
"c:\Users\L1nSn0w\Desktop\CLibrary\DataStructure\Graph\source\Headers\Iterator.h", "C++", 49, 4, 13, 66
"c:\Users\L1nSn0w\Desktop\CLibrary\DataStructure\Graph\source\Headers\Iterator.hpp", "C++", 34, 4, 9, 47
"c:\Users\L1nSn0w\Desktop\CLibrary\DataStructure\Graph\source\Headers\Vertex.h", "C++", 27, 5, 8, 40
"c:\Users\L1nSn0w\Desktop\CLibrary\DataStructure\Graph\source\Headers\test.hpp", "C++", 532, 67, 77, 676
"Total", "-", 2892, 569, 691, 4152